texts	labels
今天東莞天氣如何	weather
從觀音橋到重慶市圖書館怎麼走	map
鴨蛋怎麼醃？	cookbook
怎麼治療牛皮癬	health
嘮什麼	chat
陽澄湖大閘蟹的做法。	cookbook
崑山大潤發在哪裏	map
紅燒肉怎麼做？嗯？	cookbook
南京到廈門的火車票	train
6的平方	calc
翻譯慷慨激昂	translation
放歌，天亮了。	music
女性時尚	tvchannel
查一下南昌到南京的火車	train
背首絕句的。	poetry
我幫媽媽洗什麼	chat
打電話給王宇婕	telephone
零零二三零六的股票	stock
調頻fm九十七點一	radio
把王世懷的號碼發給喬麗君	contacts
本期七星彩的中獎號碼是多少？	lottery
類風溼怎麼治？	health
apple	website
搜索國外大片	video
代碼000800的股票漲幅是多少	stock
秦皇島今天有什麼新聞	news
從中山到西安的汽車。	bus
葉哲是你的誰	chat
打電話給艾背	telephone
我背一下春曉。	poetry
你的啥啊	chat
嘿幹嘛呢	chat
打開酷狗並隨機播放	app
你不是豬嗎	chat
打電話給大培	telephone
長者也在嗎	chat
茄子雞蛋怎麼做？	cookbook
大骨湯的做法。	cookbook
我今天去北京了英語怎麼說	translation
這是啥啊	chat
你喜歡喝什麼茶呀	chat
所以查學西寧特鋼的股票	stock
來首唐詩小池	poetry
新建聯繫人張雨號碼是五六七	contacts
打開應用漫畫	app
北京的天氣好嗎	chat
你都不知道幾點	chat
查看電視錄像	video
去北京有什麼飛機	flight
張思文是不是大美女	chat
美國熱門的恐怖電影	video
上海到蘇州	map
最美的時光	video
幻影忍者	video
給我背一首滿江紅。	poetry
你有壓力嗎	chat
調幅am六百二十八	radio
微信是幹啥的	chat
有啥好喫	chat
週六晚上重慶衛視有轉播神探高倫布嗎	epg
根下25	calc
怎麼去泉城廣場	map
你怎麼總是失誤	chat
陳嫺TCL股票是漲還是跌了	stock
一年和嗎	chat
楊三姐告狀	video
幫我查一下今天開獎的15選5	lottery
123和34的差等於多少	calc
耳鳴怎麼辦	health
查找桑拿	video
那會不會下雨	weather
發信息給許路雨	message
能安慰安慰我嗎	chat
你還能做什麼	chat
給我找最新的盜夢空間	video
查詢中超賽事。	match
去棗莊的火車	train
如何做西紅柿炒蛋。	cookbook
排骨怎麼弄纔好喫？	cookbook
誰爲含愁獨不見	chat
哎你在幹啥呢	chat
到無錫到北京的火車有幾趟了	train
中央八	tvchannel
十分鐘後叫我起牀。	schedule
給王帥發個短信說他讓他起來尿尿	message
你能搜到小說不？	novel
買三注星期四開獎的七樂彩	lottery
我要看李連杰的電影	video
我要上網打開百度	website
我說的倒數第三句話是什麼	chat
到太湖怎麼走	map
你認識我嗎	chat
小笨近來好嗎	chat
蔣捷的宋詞	poetry
看一下今天有什麼新聞？	news
酸菜魚的做法，媽。	cookbook
查尋合肥到北京的航班	flight
幻劍書盟	website
CCTV-5節目表	epg
你有夥伴嗎	chat
笨笨你看過片嗎	chat
來個燈謎吧！	riddle
捍衛者	video
中國最強音	video
幫我查一下明天廣州到北京的航班。	flight
然後你轉了麼	chat
我要聽情動這首歌。	music
明天晚上湖南衛視演什麼電視劇	epg
電視劇火鳳凰	video
這麼聰明	chat
老版紅樓夢	video
查一下蘭州到成都的火車票	train
那你告訴我你幾歲纔好交朋友	chat
查詢柳州到昆明的列車	train
帶我去丹陽市眼鏡市場	map
古惑仔	video
背首靜夜思來聽一下。	poetry
呵呵，背首詩來聽。	poetry
男人好嗎	chat
怎樣蒸排骨最好喫的。	cookbook
你有什麼特長	chat
我想要轉發這條郵件	email
蒜薹的做法	cookbook
那是怎麼了	chat
看一下今天早上新聞。	news
女人的顏色六十九集	video
你考試掛科怎麼辦	chat
是不是隻要我說話你就說話	chat
植樹節是什麼時候	datetime
做魚怎麼做？	cookbook
最近有什麼好電影嗎？	video
搜索電影晚秋	video
清空提醒	schedule
來首宋詞。	poetry
可什麼愛我在罵你好嗎	chat
看動物卡通	video
呼叫徐媛	telephone
發短信	message
你開什麼車	chat
發短信給幺零零八六內容是十一	message
聽電話	telephone
艾萊岡給我點新聞。	news
李亞麗的工作是什麼	chat
你今天去了哪裏用英文怎麼講	translation
你好醜用英文怎麼說	translation
熱門電影有哪些啊？	cinemas
你幫我打開網站	website
小雨像什麼	chat
查看武漢天氣	weather
現在電視臺在放什麼節目	epg
煤炭板塊股票查詢	stock
搜索，西米露的做法。	cookbook
李白的將進酒。	poetry
爲什麼誇獎我	chat
現在電視臺在播什麼	epg
你好女兒這幾天有空整理了一下日本她想去的地方麻煩看一下去這些地方大約幾天是否可行報價多少非常感謝	chat
你喜歡聽什麼歌曲	chat
哪一天國際牛奶日	datetime
涼麪。	cookbook
你會喝酒嗎？	chat
元宵節還有幾個星期	datetime
撥打張月華的電話	telephone
怎麼弄紅燒肉哦？	cookbook
查詢一下明天廣州到武漢的航班	flight
給我查一下什麼時間有播放天天向上	epg
念個唐詩給我聽。	poetry
我想看中央六臺的電影。	epg
小燕子要去哪裏	chat
誰在和你對話	chat
常州天氣預報	weather
汪進祥怎麼樣	chat
明天回廣州的航班	flight
環球旅遊明天有演我愛飯米粒	epg
我要看c c t v一	tvchannel
打電話給阿敏	telephone
問問你做什麼呢	chat
爲什麼你是機器人	chat
幫我找首詩。	poetry
多少錢	chat
中超A組比賽結果分別是多少	match
武漢的精確時間是	datetime
收看安徽衛視節目。	epg
一加一用英語怎麼說	translation
上QQ我	app
最近有什麼熱門的電影？	cinemas
中國合夥人	video
你學什麼的？	chat
CCTV7軍事農業	tvchannel
你再給我推薦幾本書	chat
查找盧米埃銀泰電影院有播放什麼好看的電影嗎	cinemas
設置定時關機。	schedule
90年代林心如演的電視劇	video
介紹一下尖銳溼疣	health
發信息給老婆說我不回家喫飯了	message
新蛋網	website
翻譯李淼	translation
室友秀恩愛怎麼辦	chat
打電話給幺三八八九六七五八六七	telephone
小兵張嘎電影兒	video
趙包子怎麼做的，你？	cookbook
到北京的火車班次	train
現在哪個臺在播放劇情電視劇	epg
做麪包的配方。	cookbook
來首我的未來不是夢	music
我想聽忐忑這首歌打	music
搜索QQ	app
你成長了多少	chat
怎樣做糖醋排骨時，去喫飯洗澡了。	cookbook
播放田園的歌	music
查找90年代好評的武俠電影	video
你會唱歌嗎來一首	chat
海棉寶寶	video
知青	video
牛肉麪，哦。	cookbook
來一首，靈巖。	poetry
如何治療感冒	health
北京體育頻道明天的節目單	epg
我的愛金枝玉葉	video
你孝順父母嗎	chat
六安市飛雲衛生院在哪裏	map
中央一套什麼時候有建黨偉業	epg
把張玉娟的手機號碼發送給吳偉	contacts
今天天氣冷嗎	weather
苦瓜要怎麼做比較好喫	cookbook
打電話給盧靜	telephone
打開語音軟件	app
你最近幹嘛呢	chat
幫我打開電話本	app
查詢三一重工股票	stock
從聊城到東營的車。	bus
長沙到懷化的汽車。	bus
笨笨生氣了嗎	chat
香蕉的英語怎麼說	translation
騰訊股票昨日收盤價	stock
查看濟南到東營的，汽車。	bus
能山藥怎麼做？	cookbook
八月十一日從廈門飛往上海的航班	flight
合肥到蕪湖的火車票	train
附近電影院。	cinemas
我國是誰	chat
思春夜喜雨下一句是。	poetry
得了肝癌怎麼辦？	health
濟南去聊城的汽車。	bus
給周玉發短信	message
人造雞蛋的配方。	cookbook
你早上幾點鐘起牀	chat
怎樣炒肉。	cookbook
看空霸	video
給於海洋發短信	message
那你想當男生還是想當女生	chat
鄭州天氣怎麼樣	weather
洛陽至西安的火車	train
幫我搜索一下今天的新聞	news
大家今天心情如何用英語怎麼說	translation
新疆大盤雞的做法。	cookbook
上海到青島的飛機票	flight
我也是總是困怎麼辦	chat
大連飛往上海的航班	flight
我想知道深圳明天的天氣	weather
久久鴨怎麼做？	cookbook
唱一首簡單愛	music
你去玩手機了吧用英語怎麼說	translation
漂亮和醜你是哪個	chat
紅薯粉的做法，了。	cookbook
聽聽新聞。	news
雙色球的開獎號碼是多少？	lottery
前列腺炎該怎麼治？	health
我想打你英語怎麼說	translation
給許浩發一條短信	message
伊利股份股票	stock
煮麪怎麼做？	cookbook
來一首李煜的詞。	poetry
我覺得什麼	chat
胃炎怎麼治？	health
湖南衛視娛樂節目。	epg
不想上班怎麼辦	chat
呃發信息給周玉豪	message
我要答覆郵件	email
明天去南昌的航班。	flight
出門去年是個這麼快呀	chat
我也聽新聞。	news
乳腺炎。	health
多想聽新聞，哦。	news
查七樂彩開獎結果	lottery
去你的用英文怎麼說	translation
汪意發是誰	chat
麻辣燙做法。	cookbook
中央臺五套	tvchannel
明天長沙到上海的航班	flight
紅燒土豆怎麼燒？	cookbook
寧鄉到長沙怎麼走	map
中信證券股票	stock
金瓶梅	video
開啓通訊錄	app
最近的科幻大片兒，有什麼？	video
我在跟你聊天兒嗎	chat
簡單的，糖醋排骨怎麼做？	cookbook
有什麼重要新聞嗎？	news
瀋陽今天天氣	weather
給我搜搜什麼電視臺什麼時間有轉播神探高倫布	epg
opera瀏覽器	app
出來約炮嗎	chat
我想聽昨天晚上的新聞。	news
最近好看的小說	novel
明天瀘州天氣如何	weather
設置提醒。	schedule
沙眼。	health
給園園發短信	message
民間小炒肉的做法。	cookbook
直接點什麼時候找到對的他	chat
管我什麼事	chat
哦來一首青花瓷	music
發短信給啊媽說車票買到了	message
魚香肉絲肉怎麼做？	cookbook
福建電視臺	tvchannel
明天珠海到青島的航班	flight
風車第十五集	video
發信息給熊偉	message
來一個燈謎，你。	riddle
甲型肝炎。	health
今天東莞新聞。	news
現在最好看的電影。	epg
查一下蘇州到洛陽的火車票	train
幫我查一下可樂雞翅怎麼做？	cookbook
南京到成都的機票	flight
世界地理的節目單	epg
你爲啥叫笨笨	chat
浙江電視臺	tvchannel
我要看湖南臺	tvchannel
辣，蘭州拉麪的配方。	cookbook
搜索電視劇愛情悠悠藥草香在哪個頻道首播？	epg
發郵件給瑩瑩說我好睏我想睡覺	email
打開個性鬧鐘	app
很晚了你不睡覺嗎	chat
早點死英文怎麼翻譯	translation
回看安徽衛視烽火佳人	epg
查找校園小說沙漏第二部	novel
勝者即是正義	video
烤牛排怎麼做？	cookbook
蒼溪的天氣	weather
我要查彩票的開獎信息。	lottery
大頭兒子小頭爸爸	video
查下李寧公司的股票	stock
給王濤打電話	telephone
給我講個長篇小說。	novel
電影中國合夥人	video
幫我轉發郵件	email
打電話給之山	telephone
查尋上海能源的股票	stock
告訴我今天的新聞內容	news
深圳至合肥的火車票	train
不怕啥	chat
我要看中央五臺	tvchannel
你認識徐俊嗎	chat
這個新聞有意思嗎	chat
怎麼治療口腔潰瘍呃呃呃	health
送黃炒雞蛋怎麼做？	cookbook
紫菜蛋花湯。	cookbook
來首隻愛你一個。	music
得了艾滋病怎麼辦	health
愛情公約	video
我想寫一個新郵件	email
進入訊飛官網	website
煲雞湯呢	cookbook
天氣如何	weather
幫我查一下贛州到杭州的火車票	train
誰美	chat
搜索結束軟件	app
答覆，我要聽新聞。	news
燈謎惑下。	riddle
我要猜字謎不笨有答案。	riddle
給我接聽電話	telephone
到鄭州火車站	map
知道麼	chat
7月25號去上海的航班。	flight
我要看古典仙俠小說	novel
查一查同方股份的股票	stock
我想看斯皮爾伯格導演的電影	video
你愛哈工大嗎	chat
撥打幺三九七七零九八七七六	telephone
去湘江	map
大閘蟹的做法。	cookbook
來一首月亮惹的禍	music
回鍋肉。	cookbook
來個最新新聞。	news
昨天的北京新聞	epg
新紮師妹	video
我要聽新聞，給我數。	news
貴溪至泉州的火車票	train
還要臉嗎	chat
打開豐順縣政府網	website
準備好了嗎？	chat
中國新聞網網站	website
看一看大樂透的信息	lottery
陳真	video
今天有些什麼電影？	epg
豔照門事件。	news
笨笨你的底層是基於什麼算法啊	chat
江蘇舜天隊這個星期的比賽時間給我找出來	match
大樂透中獎號碼爲	lottery
肥東人民廣播電臺調頻FM101.3	radio
給我來首唐詩三百首。	poetry
唐寅的詩。	poetry
長沙明天是什麼天氣	weather
幫我查一下週杰倫的歌	music
打開系統軟件清理	app
怎麼對	chat
發短信給葉少雲晚上要不要出去玩	message
你有幾個小妹妹	chat
放首歌聽一下你好	music
那做紅燒魚需要哪些材料啊？	cookbook
怎麼做魚呢？	cookbook
靜脈曲張怎麼治療？哦？	health
出租車的英文怎麼說	translation
我想聽11年，這首歌哦。	music
科大訊飛今天的股票	stock
播放歌曲再見青春	music
怎麼煮麪纔好喫呢？	cookbook
23減去根號4	calc
我想聽首歌	music
幫我查一下杭州到長春的飛機航班	flight
但還是很差	chat
搜一下CCTV74月15號播出新編輯部的故事呢	epg
會英文嗎	chat
各來一首李白的詩詞。	poetry
我想看高爾夫網球頻道	tvchannel
央3	tvchannel
青春期撞上更年期二	video
中央六臺有什麼節目	epg
給我查一下最近在播哪些電影	cinemas
從杭州到黃山的汽車。	bus
你給我背一首白居易的詩。	poetry
我不在家英語怎麼說	translation
剛纔你說你叫啥來着	chat
爲什麼要請你	chat
打開uc瀏覽器v八	app
心術電影	video
提醒我明天約老同學。	schedule
我說鐵鍋燉羊肉怎麼做？	cookbook
你都會啥啊	chat
我們做愛吧用英文怎麼說	translation
怎麼教你變聰明	chat
中央四頻道火箭兜風	epg
朗讀詠雪	poetry
打開索尼官方網站	website
從西安到石嘴山的汽車票。	bus
電視臺在播什麼節目	epg
蘇寧易購	website
北京卡酷熊出沒	epg
你真笨，是四喜丸子怎麼做了。	cookbook
搜索最近的，科幻電影。	video
你啥時候出現的	chat
還是想知道你能做些什麼	chat
我要聽中超第二十，八輪的結果。	match
魚的做法	cookbook
七星彩	lottery
貴陽至長沙的火車票	train
新浪汽車	website
搞笑謎語。	riddle
求米線怎麼做？	cookbook
笨笨我不喜歡你這個名字你可以給自己換一個麼	chat
你怎麼知道呢	chat
把僑天慧的號碼發給副卡	contacts
搜索七樂彩的公示號碼	lottery
幫我搜一下科大訊飛在哪	map
我要去姜堰	map
打電話給摩托老師	telephone
命運派對	video
打開三星首頁	website
午飯怎麼辦	chat
但我想點新聞。	news
你好嗎你好嗎好嗎	chat
天氣怎樣	weather
孫翠魚怎麼做？	cookbook
CCTV少兒	tvchannel
從我這裏去芙蓉區政府怎麼去	map
查詢一汽轎車股票	stock
你叫什麼啊	chat
發送短信給陳羣	message
你是醫生嗎	chat
什麼東西	chat
牛肉怎麼煮纔好喫？你？	cookbook
幫我查一下15選5開獎結果	lottery
查個字謎。	riddle
麻煩您可不可以幫我調頻99.3嘉善人民廣播電臺	radio
但是我想上騰訊網	website
上海寶鋼股票	stock
章源鎢業	stock
巴中的天氣	weather
導航到佛山大良汽車站	map
黃豆豬蹄湯。	cookbook
激動	website
打電話給潘立長	telephone
到步行街不走高架的路線是哪條	map
搜索蒙牛的股市行情	stock
廣州到孝感的火車	train
搜狗	app
薛平貴與王寶釧	video
打電話零九一零二五六五三五四	telephone
洛陽的天氣	weather
你有牙嗎	chat
98.4香港電臺第四臺	radio
我不明白用英文怎麼講	translation
人福醫藥股票	stock
提是誰	chat
上週六發現之旅有演星跳水立方呢	epg
給曉琴發短信你在幹嗎	message
給原波發短信	message
陰精英語怎麼說	translation
後天去武漢的航班	flight
林芝喫什麼	chat
你知道我幾歲	chat
搜索中國移動的股市行情	stock
慕斯的做法。	cookbook
查詢昆明到合肥的火車	train
講點新聞	news
啥時候長大啊	chat
根號76	calc
就是很想看一下大衆影院	tvchannel
燉鰱魚怎麼做？	cookbook
那你教我怎麼搭訕好了	chat
江蘇影視	tvchannel
誰傻	chat
a排骨怎麼做好喫？	cookbook
我要看遊戲異界小說	novel
看中央七頻道講武堂節目	epg
石螺怎麼煮	cookbook
臨沂的天氣	weather
什麼季節	chat
給張克達發短信	message
小朋友的媽媽是誰	chat
有什麼用呢	chat
如何做芝麻糊。	cookbook
打電話給丹丹移動	telephone
尿道炎怎麼辦	health
女子特警隊之火鳳凰	video
十二與32的積是多少	calc
誰罵你	chat
怎麼做冰激凌？	cookbook
四川新聞網	website
影視流星花園	video
瓷我要上QQ	app
如何炒花生。	cookbook
南航1003	flight
講一個謎語和答案。	riddle
你認識微軟小冰嗎	chat
我心照明月後面一句是什麼？	poetry
福壽魚做法。	cookbook
幫我找到去安徽黃山的路	map
如何做煎餅。	cookbook
本週還有什麼待辦事項	schedule
喫啥藥	chat
﻿你好慢嗎！	chat
給青發短信	message
給我背個李白的詩。	poetry
如何治療頸椎病。	health
濟南到漢中的飛機票	flight
幫我搜索一下有什麼家常菜？	cookbook
打開相機我想你	app
怎麼分擔	chat
電視臺列表	tvchannel
看網易財經	website
你父母是誰	chat
馬家溝是個好學校嗎	chat
查看汕頭天氣	weather
寧波到岳陽的汽車。	bus
fm九零二	radio
智取威虎山	video
魚要怎麼煮纔好喫	cookbook
潘靖的電話是多少	contacts
我把相機打開	app
搜索下綠巨人	video
學而不厭，下一句是什麼？	poetry
打開uc瀏覽器登錄新浪網主頁	app
搜索熱門電影。	cinemas
前兩個星期時代出行有播X女特工呢	epg
教我做饅頭。	cookbook
酸菜是怎麼做的可以用塑料布。	cookbook
電視臺放什麼	epg
2013年中國男足，主要賽程。	match
陳楠帥嗎	chat
怎麼做洋蔥炒蛋？	cookbook
背屈原的離騷	poetry
幫我在百度裏搜一下東莞到北京的火車	train
查一下那個南京到昆明的火車	train
六臺有什麼節目	epg
最近有什麼熱門新聞了。	news
你喜歡玩什麼遊戲啊	chat
能幫我收聽淄博音樂廣播	radio
要看名偵探柯南	video
你認識嗎	chat
你不下去麼	chat
今天湖南衛視的電子節目單	epg
能想起我嗎	chat
田螺怎麼炒啊？	cookbook
北疆戰士	video
我說什麼	chat
查一查上影電影院即將上映的影片	cinemas
開心大冒險	video
查尋來賓到柳州的火車	train
那你背首唐詩給我聽。	poetry
我要打開百度	website
你體重超重了嗎	chat
找憤怒的小鳥	app
上美空網	website
中水漁業的股票	stock
很高興見到你英文怎麼講	translation
幹嘛好	chat
意大利麪。	cookbook
查查最近一週CCTV-4美洲有放我愛記歌詞麼	epg
搜索機鋒市場	app
查詢廣州到海南的航班	flight
你認識宮慶紅麼	chat
發短信給賢想快點給我送早飯開門我餓死了	message
烤雞翅怎麼做？	cookbook
怎麼不懂講晚安呢	chat
8點河北衛視播放過戀了愛了	epg
趕集	app
他教你這麼說的呀	chat
導航去科大訊飛	map
五八零零二二的市盈率是多少	stock
蛋糕好喫嗎	chat
索尼愛立信官網	website
鄭州火車站怎麼走	map
我要回復這條郵件	email
哪裏找小姐	chat
全部應答	email
看電影啊	video
這麼嚴肅的事爲什麼好笑呢	chat
你明白什麼	chat
查詢泉州到上海的動車票	train
寧波天氣情況	weather
什麼零食	chat
你想他幹嘛	chat
給木九超打電話	telephone
啊，青椒炒蛋。	cookbook
上海到合肥怎麼坐汽車？	bus
培根金針菇怎麼做？	cookbook
從連雲港到北京該怎麼走	map
誰的尾巴短短的	chat
您給我來一首，夏明翰的就義詩。	poetry
切換到a t v	tvchannel
回看上週末早上8點的湖南衛視	epg
把平水相逢的手機號碼發給8000	contacts
給張大萍發短信	message
播放黑貓警長。	music
我想看變形金剛三	video
加，聽新聞。	news
中國銀行股票怎麼樣	stock
查詢4月1號從武漢到廣州的航班	flight
搜王菲演唱會	video
廣州恆大亞冠聯賽，比賽時間。	match
那是啥	chat
西蘭花怎麼做？	cookbook
太原到廣州的車。	bus
醬茄條做法。	cookbook
那你喜歡做機器人麼	chat
你知道小寶寶上幼兒園哭嗎	chat
開啓雅虎	website
幫我寫個郵件	email
智慧樹	video
打開互聯網啦	website
寧波到杭州的汽車	bus
給莊小雷發短信	message
發信息給董昊老婆	message
蝦炒蛋怎麼做？	cookbook
打電話給鄭藝紅	telephone
今天天氣怎麼	chat
我想看搞定岳父大人電影	video
我去飛機場英語怎麼說	translation
四川美食。	cookbook
天利	stock
四喜丸子怎麼做？	cookbook
你來自哪個星球	chat
海南旅遊衛視	tvchannel
翻譯爸爸	translation
明天到合肥的火車	train
看看最近有什麼電影？	video
﻿怎麼坐車去廣州？	bus
庫裏是不是傻	chat
嗨喫晚飯了嗎	chat
給我來一首山歌嗎？	poetry
央視1高清	tvchannel
再來一個腦筋急轉彎	riddle
蘇電影我們都是壞孩子。	cinemas
中國共產主義的英文怎麼說	translation
上海到淮安的飛機	flight
提醒我明天約了老同學的小聚一下。	schedule
說一句，白居易的詩。	poetry
調頻到fm八八五	radio
打電話陳雪莉	telephone
瀏覽一下百度	website
把許琦彪的號碼發給徐鵬	contacts
明天8:10叫我啊!	schedule
查一下杭州到鷹潭的火車票	train
遼寧大連在哪裏	map
我想看愛情闖進門	video
來一首七言絕句。	poetry
chc高清電影昨天晚上的節目	epg
你是豬還是牛呀	chat
廈門到贛州的火車票	train
我想上網易	website
黃狼。	contacts
桔子英文怎麼說	translation
扁豆豆角怎麼燒？	cookbook
熊出沒是幾點開始播放。	epg
請問一下軍事新聞。	news
今天全椒天氣怎麼樣	weather
你會下象棋嗎	chat
替我打開新郵件	email
看一下中式傳媒股票的漲跌幅	stock
新建聯繫人張三電話號碼一二三四五	contacts
高清深圳臺	tvchannel
現在打開你的官網	website
米粉肉怎麼做？	cookbook
今天惠州新聞。	news
遊戲競技頻道	tvchannel
貓眼三姐妹	video
你這答覆邏輯也是沒誰了	chat
2013年陳可辛導演的好看的電影	video
松菜魚怎麼做？	cookbook
給我定一個8:10的鬧鐘。	schedule
給何建琴發短信	message
給楊燕姐發短信	message
明天的天氣是是什麼	weather
你不開心會做什麼	chat
張，來首白居易的詩。	poetry
念首詩聽一下。	poetry
可是我問你啥都聽不懂啊	chat
叫你笨笨你敢答應麼	chat
幫我翻譯一下番茄	translation
你給我念一首李白的詩。	poetry
南鋼	stock
香港杜琪峯導演的喜劇孤男寡女	video
深圳到開封的火車	train
搜索大樂透的中獎號碼	lottery
我上課罵了學生怎麼辦	chat
甲亢怎麼辦？	health
查看婷婷的號碼	contacts
龐軍軍英語怎麼說	translation
查詢沿途的KTV	map
嗯打開相機	app
查詢衆樂電影院最熱門的電影	cinemas
你的性別是什麼	chat
現在在哪	chat
天氣桂林	weather
從合肥去西安的火車	train
趕集網	website
什麼評論呀	chat
綠色的啥	chat
青島到廣州航班	flight
給吳方婷打電話	telephone
天機富春山居圖	video
13年的電影	video
天津電視臺的國際頻道，拜託了哈	tvchannel
做紅酒怎麼做啊？	cookbook
誰在雪裏跑	chat
誰跟你說沒對象了	chat
花格等蛋的做法。	cookbook
報點新聞給我聽。	news
給高興打電話	telephone
查一下明天福州的天氣	weather
南昌到廣州飛機票	flight
你出生在哪	chat
甄嬛傳高清	video
我所在地理位置	map
去網上搜索蘭陵王。	poetry
去廣州的火車票	train
查詢神鬼認證	video
買幾瓶	chat
國際象棋開局	app
肉肉怎麼醃製？	cookbook
你哪人啊	chat
CCTV-10的百家講壇	epg
打開河南英東網站	website
明天天氣如何	weather
完了你和多了你在哪裏自己都不知道咯	chat
瞌睡魚怎麼做？	cookbook
打開百度啊	website
呼和浩特的天氣怎麼樣呢	weather
你好請問一下明天廣州的天氣如何	weather
搜索武漢到南京的機票	flight
溫州到上海的車。	bus
打電話給王安娜	telephone
幺三零二三八四七三四二	telephone
太陽第九集	video
打給親愛的樓	telephone
導航到山東省菏澤市王浩屯鎮	map
天氣好不好啊	weather
﻿打開熊貓看書	app
我要聽還是會這首歌	music
查詢東吳證券的股票	stock
聊些什麼呢	chat
你有繩命嗎	chat
蛋炒飯怎麼煮	cookbook
蒸魚。	cookbook
今天杭州有什麼新聞	news
宮外孕怎麼辦？	health
焦點訪談什麼時候播	epg
你喜歡什麼啊	chat
打開手機QQ恩	app
湖北電視臺高清	tvchannel
中超比賽結果，今天呢？	match
金醬肉絲的做法	cookbook
上海申花的賽程。	match
到了有鱸魚怎麼做？	cookbook
晚上8:10叫我起牀。	schedule
我的幸福	video
蠔油生菜的做法。	cookbook
轉發這條mail	email
瘦肉粥。	cookbook
王志排骨怎麼做	cookbook
人之初，性本善下一句是什麼？	poetry
隨便唱幾首歌吧	music
今天電影頻道演什麼	epg
收聽中國人民廣播電臺廣播	radio
結婚了嗎	chat
打電話給魏文強	telephone
給張倩倩發短信	message
摩爾勇士	website
現在有什麼好看的電視劇？	epg
基哥喜歡我咋辦	chat
福爾摩斯	video
鈦備份	app
武間道	video
請幫我找一下酸菜魚的做法	cookbook
深圳今天天氣怎麼樣	weather
合肥明天的溼度如何	weather
明天南京到徐州的火車	train
打開會說話的湯姆貓	app
最近在播什麼電影？	cinemas
淋病怎麼辦	health
江蘇影視臺	tvchannel
給楊李鵬發短信	message
我要查股票	stock
花開半夏	video
怎麼做京醬肉絲。	cookbook
播七龍珠	video
廣州恆大的賽程。	match
你玩什麼遊戲打野	chat
聊不下去了怎麼辦	chat
請打開電影	video
我前任男朋友你猜是什麼職業	chat
玄幻小說《武動乾坤》	novel
來一首詠柳。	poetry
講一個謎語，啊，你，哦。	riddle
我想看董浩配音的動漫	video
喜歡男孩還是女孩	chat
爲什麼睡不着	chat
怎麼找女朋友	chat
進入設置菜單	app
替我查看新郵件	email
把徐程的電話發給吳芳	contacts
你是不是呆萌啊	chat
西藏衛視	tvchannel
大樂透的開獎情況	lottery
在哪喫	chat
打給曾瑋文	telephone
愛在何方第三期	video
水餃的做法。	cookbook
馮沙排骨怎麼做？	cookbook
有道詞典	app
偏頭痛怎麼治？	health
添加一條通訊錄姓名葛勇手機號碼189571642496	contacts
發短信給王亮說死人你在幹什麼呢	message
你除了喜歡我害羞的樣子還喜歡我的什麼呢	chat
播放法制進行時	video
現在哪個頻道播放電視劇	epg
白灼菜心怎麼做？	cookbook
嫁雞隨雞下面一句是什麼？	poetry
那烤箱做麪包怎麼做？	cookbook
安徽電視臺12月18號晚上10:10的電視劇	epg
放首歌給我聽吧	music
哈嘍好久不見你開心嗎	chat
我要看魔法神話小說	novel
杭州南站到龍游的火車有哪幾班	train
央視三臺現在播放什麼節目	epg
我看你還是不太行	chat
我想聽聽今天的新聞。	news
廣州至南寧航班。	flight
在哪裏出門右轉	chat
美好的時代	video
我想聽傷感歌曲	music
幫我查一下廣州到長沙的航班	flight
我要看免費的小說。	novel
是我是說你有幾個兄弟姐妹不是你自己說	chat
給姐姐發短信我今天晚上晚點回去你就別等我喫飯	message
那你願意嗎	chat
查尋天龍集團的股票	stock
打開三g門戶網站	website
你早上一般幾點起牀	chat
江山有奇峯，下一句。	poetry
朗讀遊子吟。	poetry
截癱吧	health
撥打電話給莊開森	telephone
五號特工組	video
你去哪用英文怎麼說	translation
我想今天新聞最近有什麼新的新聞？	news
大連天氣	weather
又熱炒雞蛋怎麼做？	cookbook
你叫什麼名字英文怎麼說	translation
趕緊推薦一部小說。	novel
打開節目搜索	video
魚香肉絲哦	cookbook
幫我搜一下中超3月份的對陣情況	match
現在星期幾	datetime
今天的新聞有什麼？	news
瀋陽喫什麼除了粘豆包烤冷麪燜子瀋陽喫什麼除了粘豆包烤冷麪燜子	chat
你可以做什麼	chat
多少月之後就是過年了	datetime
發燒好嗎？	health
呼叫零二二二九一一四八六	telephone
笨笨真的會聊天嗎	chat
請查詢豐城到南昌的火車列車列車時刻表	train
你知道什麼的什麼是什麼嗎	chat
你是啥啊	chat
幫我查下南京明天的天氣	weather
過油肉土豆片怎麼做？	cookbook
查一下沿途的科大訊飛	map
怎麼做炸雞	cookbook
教我怎麼做紅燒肉	cookbook
根號3是多少	calc
搞笑的鬼片	video
到環都大酒店怎麼走	map
說說嗎	chat
能告訴我你的性別麼	chat
妖精的尾巴	video
查詢上海到玉林的航班。	flight
打電話給奧巴馬	telephone
中國石化的股票是漲還是跌	stock
查看最近的日程	schedule
幫我來一首蘭陵王。	poetry
打開sky電話	app
海爾濱現在幾度！	chat
儋州到海口的航班	flight
咳嗽怎麼治？	health
嘉興糉子。	cookbook
誰在買扇子	chat
白麪粉可以怎樣做餅？	cookbook
椒鹽排骨怎麼做？你？	cookbook
打電話給胖頭	telephone
九江到景德鎮的汽車。	bus
藍精靈電影	video
明天有沒有洛陽到西安的高鐵	train
魚香肉絲，怎麼做？不？	cookbook
發信息給老媽說我在喫飯	message
幹嘛去	chat
查尋科大訊飛的股	stock
我要看現代重生小說	novel
x戰警第一部	video
如何治療龜頭炎。	health
上山居網	website
請幫我調頻89.6武漢交通廣播電臺	radio
我想看張藝謀導演的電影	video
4的2次方根	calc
搜搜一首毛澤東的詩。	poetry
你只會說這些嗎	chat
啥叫換手機如換衣服啊	chat
把淘寶網打開	website
豬舌頭怎麼做比較啊子？	cookbook
海星的做法。	cookbook
你妹叫傻傻麼	chat
打開杜鑫文的網站	website
15加上2的平方	calc
有你才幸福	video
我想聽情花開這首歌	music
給梁輝堅發短信	message
你知道誰是謝志偉嗎	chat
魔幻手機	video
揚州天氣	weather
四月六號南寧到上海的火車	train
紅燒排骨怎麼做？啊？	cookbook
搜索逃學威龍第二部	video
從新加坡花園怎麼去寧溪路	map
先鋒乒羽	tvchannel
老故事	tvchannel
陝西二套	tvchannel
你會唱歌麼	chat
你睡午覺嗎	chat
哪個倒黴孩子給你起這個名兒	chat
搜索中國移動股票	stock
呲牙你不是說你好聰明嗎	chat
我說不怎麼喜歡喫辣的	chat
傑瑞股份股價	stock
音樂播放器	app
幫我切換到湖南衛視	tvchannel
打開寬帶商務網站	website
羅山天氣	weather
幫我查一下臨海到上海的火車	train
查一下運城到臨汾的汽車。	bus
查詢濮耐股份的股票	stock
高清央視綜藝	tvchannel
發送短信給東莞李月華就說今天趕緊回來	message
一起聽聽新疆人民廣播電臺	radio
2013年的警匪電視劇	video
講個笑話嗎	chat
想去哪	chat
打開qq登陸到聊天模式	app
中超比賽，結果。	match
魚肉怎麼做？	cookbook
恆大山東魯能比分是多少？	match
來一首納蘭性德的詞。	poetry
哪些臺在放電影	epg
給我放首歌	music
請翻譯蘋果	translation
長了什麼?	chat
請給我講一下今天的新聞吧！	news
牛骨湯	cookbook
找一下詹姆斯卡梅隆拍的電影	video
查一下零零零八六八的股票行情	stock
我人品好嗎	chat
中央十一臺	tvchannel
明早8:10叫醒我。	schedule
給張金波發短消息今天中午一起喫飯	message
進你的官網	website
打開蘋果香港官方網站	website
上一期雙色球開什麼	lottery
我女兒想去哪裏	chat
保定天氣	weather
最近有什麼好看得	video
你有喜歡的人嗎	chat
幫我查一下明天南昌到廣州的飛機票	flight
白切雞怎麼做啊？	cookbook
北京財經	tvchannel
北京臺有什麼好電視	epg
我想看c c t v 一頻道	tvchannel
麻辣串應該是四川的吧不是哈爾濱的哈爾濱應該喫的是不胖葫蘆吧對不對還是北京啊	chat
查一首古詩，武林春。	poetry
怎麼看見的不可能	chat
永輝超市股份的價格	stock
遠教四臺	tvchannel
請幫我調頻106.1長沙音樂廣播電臺	radio
哪裏可愛了	chat
吉林到大連的車。	bus
我想親親我的寶貝這首歌	music
溫州到瑞昌的火車	train
打電話到飛雲	telephone
從威海到蘇州的飛機	flight
撥打電話辦公吳菲	telephone
查看一下天氣預報	weather
山寨魚怎麼做？	cookbook
最近有什麼好看電影了？	video
幫我查一下合肥市三孝口在哪裏	map
請念一首毛澤東詩詞。	poetry
搜索蘭陵王。	poetry
播放，青島中能的賽程。	match
幫我查找一下今天晚上有什麼電視節目？	epg
找找非誠勿擾什麼時候結束	epg
播放最近的新聞。	news
你能幫我寫作業嗎	chat
做蛋撻怎麼做	cookbook
我想看一下鳳凰網	website
伊利股份	stock
中國製用英文怎麼說	translation
我想看變形金剛哦	video
腿英文怎麼說	translation
怎麼這麼多雞湯	chat
從南京到亳州怎麼走	map
哪裏有小貓	chat
紅燒肉的做法，a。	cookbook
電影院有什麼電影？	cinemas
給劉西發短信	message
有什麼重大新聞	news
換江蘇衛視	tvchannel
哪有雪	chat
AXN	tvchannel
麻煩您能否幫我調頻97.1漢中音樂廣播電臺	radio
講個腦筋急轉彎，我，我格，你是誰？	riddle
我想看電影超人	video
我今天幫爺爺洗衣服的英文怎麼說	translation
我想看一下科大訊飛的股票	stock
爲什麼欺負你	chat
去汽車南站怎麼走	map
我正在睡覺用英語怎麼說	translation
來一句唐詩唄！	poetry
來個字謎我猜一下。	riddle
查一下濟南到成都的航班	flight
給蛋炒飯怎麼做？	cookbook
臘魚。	cookbook
安徽合力股票	stock
上海東方衛視現在在播放什麼？	epg
搜索湖南衛視直播。	epg
3的平方除以2的立方的商的倒數	calc
我想聽春天裏這首歌	music
我想聽蔡依林的倒帶這首歌	music
國防軍事頻道2天后播捍衛者	epg
番紅燒肉的做法。	cookbook
必須你說一句我說一句嗎	chat
浙江臺	tvchannel
新建聯繫人振華奎號碼是幺三五零八九四九三幺二	contacts
我咋不知道這事兒呢啊明星啊之心知肚明啥意思	chat
能不能看當前的中超聯賽	epg
打電話給陳雷	telephone
嗯，你來一首李白的詩詞，的。	poetry
紅燒獅子頭怎麼做	cookbook
123和34的和等於多少	calc
歐陽震華的罪案電視劇	video
廣州到南寧的火車	train
愛我什麼	chat
華晶小學在哪裏	map
那你怎麼提高自己呀	chat
你有妹子嗎	chat
新建聯繫人買當嘮4008 517517	contacts
哪去	chat
哪個電視臺在放神鵰俠侶。	epg
宿州到北京的火車有哪些	train
包皮過長，怎麼辦？哦。	health
愛什麼	chat
你能幹什麼啊	chat
一晚多少錢	chat
我想看足球中超，第25輪的比賽時間。	match
打電話給三路店	telephone
鴿子，怎麼做最好喫？	cookbook
看今天的新聞。	news
今天是個好日子的英文怎麼講	translation
你覺得腳踏兩隻船怎麼樣	chat
都有啥啊	chat
你是不是中文比較差	chat
幫我算一算45的平方根	calc
歧路兄弟	video
八月十號從重慶到武漢的航班	flight
鷹潭到景德鎮	map
你這麼厲害呀	chat
我是學渣嗎	chat
湖裏公園在哪裏	map
從我這裏到科大訊飛走高速路線	map
牛肉的做法。	cookbook
生活大爆炸	video
把我打開UC瀏覽器	app
打開珠江臺	tvchannel
最新的新聞播報一下	news
最近1周北京電視臺-4有轉播X女特工呢	epg
請問意大利麪怎麼做	cookbook
狐臭怎麼治？	health
那我長什麼樣	chat
讀句詩來聽聽。	poetry
發信息給盛吉	message
媽媽的花樣年華	video
合肥百貨大樓在哪裏	map
周慧的電話。	contacts
楊冪演的恐怖片	video
央視綜合頻道昨晚的節目單	epg
13年孫紅雷演的片子	video
忍者之路	video
猜個謎語哦。	riddle
回看烽火佳人回看安徽衛視烽火佳人	epg
川崎玫瑰的製作方法	cookbook
語音火鍋怎麼做啊？啊？	cookbook
喜羊羊與灰太	video
7月30號去深圳的航班。	flight
不是我是說我給你猜個謎語吧！	riddle
老朗誦首古詩。	poetry
汕頭到重慶的航班	flight
幫我購買2注大樂透的彩票	lottery
你認識xx嗎	chat
笨笨爲什麼不叫聰聰	chat
這不是你的名字嗎😂	chat
呼叫廣歲	telephone
撥打陳艾電話	telephone
爲啥要刷盤子呢	chat
給我搜索腦筋急轉彎。	riddle
播新聞，湖南新聞。	news
百度百科	app
幫我開捕魚達人	app
杜雨萌學姐是誰	chat
不多不要緊都會什麼	chat
明天去桂林的航班。	flight
哪裏	chat
給小魚打電話	telephone
新建聯繫人姓名張三號碼一二三四五六七八	contacts
你說啥呢好惡心	chat
做南瓜飯	cookbook
合肥的大潤發在哪	map
我們現在在什麼地方	map
來首快樂崇拜	music
土豆粉怎麼做？	cookbook
回鍋肉做法。	cookbook
臺中的天氣	weather
美國最近有什麼新聞	news
從二手車市場到八一廣場怎麼走	map
我喜歡亞楠用英語怎麼說	translation
包莖怎麼辦？	health
訊飛科技股票價格	stock
點播愛情買賣	music
你喜歡吸毒嗎	chat
麗水的天氣怎麼樣	weather
安哥拉的英文是什麼	translation
怎麼操作	chat
腦筋急轉彎，孫。	riddle
平陽怎麼走嗎	map
湖南衛視放什麼節目？	epg
菠蘿包怎麼做？	cookbook
3的平方除以2的立方的商等於多少	calc
豬肉灌湯包怎麼做？	cookbook
你喜歡老師嗎	chat
菠蘿咕老肉的做法	cookbook
紅豆沙怎麼做？	cookbook
家常涼菜怎麼做？	cookbook
我想打電話給李四	telephone
我昨天晚上的今日關注	epg
古詩長恨歌。	poetry
做紅燒魚的步驟。	cookbook
對啊我也這麼覺得	chat
發短信給上海浦東發展銀行　95528	message
可樂雞翅怎麼做呀晚點告訴我。	cookbook
劉三姐	video
查看滁州到南京的火車票	train
頸椎病用什麼藥物治療？	health
昌魚的做法	cookbook
今天有雨嗎	weather
賽羅奧特曼	video
請打開八六八四	website
《武動乾坤》	novel
幫我查一下深圳到桂林後天的機票	flight
九月二十六號從深圳到寧波的航班	flight
青陽天氣如何	weather
你喜歡喫便便嗎	chat
天氣南京	weather
給萬結打電話	telephone
給劉三發短信說我今天沒有空	message
我在韓國你在哪裏	chat
韓國電視連續劇老大	video
BTV北京頻道打狗棍	epg
藍鷹股票	stock
蒽蒽江蘇衛視有什麼好節目嗎？	epg
現在湖南衛視放什麼電視？	epg
燒排骨湯需要什麼調料？	cookbook
牀前明月光下一句是怎麼說	poetry
正韻打開相機	app
給小陽發短信	message
這個沒什麼吧	chat
請查詢天津市到哈爾濱的車。	bus
幫我查一下今晚中年中央六臺放什麼電影？	epg
惡念首唐詩。	poetry
發短信給幺八六六七九零三五八零	message
紅燒魚塊。	cookbook
還是不用了吧	chat
那就來一首李白的詩詞。	poetry
2平方	calc
南京火車站到南京農業大學	map
沿途有沒有加油站	map
你認識裘實麼	chat
你是男是女還是人妖	chat
我給你說個，我給你說個謎語你猜得出來嗎？	riddle
江蘇陽光的股票怎麼樣了	stock
來一首白居易的長恨歌	poetry
科大訊飛昨日成交價	stock
紅燒豬腳	cookbook
我想知道環球影視明天播放什麼電影	cinemas
是的咯還是笨笨最好	chat
鞏捷甫是誰	chat
啥婆豆腐的製作方法	cookbook
豬肚雞怎麼做啊？	cookbook
查詢後天成都到倫敦的航班	flight
是不是有點長	chat
我要看古言小說	novel
中國教育電視臺三臺	tvchannel
美國恐怖電影	video
怎麼教你	chat
搜索蜀道難。	poetry
昨晚哪個頻道有張藝謀出演的電視劇	epg
明天去蚌埠的車票	train
明天去滁州的火車	train
基尾蝦怎麼做？	cookbook
風魔炒魚香肉絲。	cookbook
草蝦尾怎樣做。	cookbook
取消明天的鬧鐘	schedule
5的平方與3的3次方的和是多少	calc
查查一下連江到湛江的火車票	train
你去過賭場嗎	chat
能不能幫我接聽中廣流行網	radio
哪天清明節	datetime
給我打開百度網	website
恆宇樂活魚怎麼做的好喫的回覆哦，你。	cookbook
勝女的代價電視劇	video
今天農曆是多少	datetime
打打給胡磊	telephone
打電話	telephone
你會罵人麼	chat
我想聽世上只有媽媽好這首歌。	music
播放眼色	music
發條短信給張亞東	message
查找張偉軍	contacts
賣啥呀	chat
銀耳蓮子羹。	cookbook
西紅柿炒雞蛋做法。	cookbook
幫我發條短信吧	message
嗯，知道紅燒肉怎麼做？	cookbook
看千金歸來第五集	video
魚香肉絲，怎麼做得？	cookbook
天氣怎麼樣	chat
明天的天氣	weather
播放老婆最大。	music
所以說李白的詩。	poetry
哦我想看中央一臺	tvchannel
大海個小河哪個大	chat
背一首春曉	poetry
新奧爾良烤翅的做法	cookbook
看上週五的爸爸我去哪兒	video
圖靈機器人也不知道是什麼耶	chat
你怎麼樣會開心	chat
你是不是看不懂啊	chat
BTV生活節目選擇回放	epg
最近有什麼新上映的電影啊？	cinemas
查查13年的一站到底	epg
給楊斌發短信	message
我想聽莫失莫忘。	music
廣州去昆明的火車	train
哪個電視臺在演葉問。	epg
要怎麼煮飯。	cookbook
網上最火的小說有哪些	novel
我想聽音樂忘情水。	music
宮崎駿動畫電影	video
晉江到武漢的航班	flight
辣酸菜魚怎麼做了。	cookbook
膽結石怎樣治療。	health
把王建春的電話號碼發給張學政	message
幫我調明天早上8:10的鬧鐘。	schedule
來個腦筋急轉彎兒。	riddle
東方臺	tvchannel
請幫我調頻97.5湖南人民廣播電臺文藝臺	radio
最近有什麼影片？	video
我美麼	chat
騰訊公司的股票	stock
歐樹的葉子怎麼炒？	cookbook
給我念首古詩。	poetry
一個鬼子都不留	video
查詢安陽到鄭州的動車	train
來is，來一首採蓮。	poetry
那中央六臺明天演什麼節目	epg
鋼鐵俠三	video
打個謎語吧！	riddle
還能聊點啥呢	chat
涼菜是怎麼做的？	cookbook
你猜我幾歲了	chat
當前不再呼叫英語怎麼說	translation
我說白魚怎麼做	cookbook
多推薦幾個吧	chat
那你現在可以幹啥	chat
查最近的電影。	video
幫我訂一張杭州到上海的機票	flight
今晚有什麼節目啊？	epg
給金華打電話	telephone
我要購買七樂彩	lottery
提供一張大樂透	lottery
你是不是愛上別人了	chat
晚安的英語	translation
那你給我背一首唐詩吧！	poetry
太陽像個什麼	chat
給黃尚君發短信	message
週末去哪玩	chat
我要看校園小說致我們終將逝去的青春	novel
想做蛋糕。	cookbook
幫我調明天8:10的鬧鐘。	schedule
我問你怎麼走	chat
你什麼時候死	chat
今天的新聞，欲	news
你有男朋友嗎	chat
爆炒豬肝怎麼做？	cookbook
放首陳奕迅的十年	music
聚友網	website
搜索電視劇插曲	music
怎麼做飯好喫？	cookbook
背誦一首唐詩	poetry
武漢的明天天氣	weather
情債	video
我要看魔幻學院小說	novel
搜索天氣	weather
我要和妹妹睡覺英語怎麼說	translation
黑菜扣肉的做法告訴我一下啊！	cookbook
腦癱	health
幫我打電話給港鐵輪	telephone
愛在旅途	video
現在有什麼好的電視劇。	epg
現在看看有最新的新聞嗎？	news
廈門到福建建陽的火車是幾點呢	train
白帶異常。	health
如果遇見狼呢小馬還會讓狼上車嗎	chat
倉央嘉措的詩詞。	poetry
那你夢想是什麼呢	chat
給我查下明天凌晨在放媽媽來了	epg
打開搜狐微博	app
不蒸了牛肉丸	cookbook
唐詩登高。	poetry
查找電影	video
查詢科大訊飛的股價	stock
中央電視臺一套現在放什麼節目？	epg
幫我查一下贛州的天氣明天呢	weather
二月一日柳州的天氣	weather
我要當八路軍	video
酸菜魚怎麼做啊	cookbook
睡覺用英文怎麼說	translation
新建聯繫人天天	contacts
給我打開mail	email
明早8:10鬧鐘。	schedule
45與53的差是多少	calc
李白的靜夜思怎麼讀？	poetry
今天有什麼新聞呢。	news
學什麼	chat
我看看現在的最新新聞是什麼？	news
把在1607的會議修改到1608	schedule
那就來一首李白的詩詞嗎？	poetry
4乘6乘七再除以二	calc
你萌嗎	chat
很高興認識你英語怎麼說啊	translation
你是講故事呢嗎你是報幕呢吧	chat
打電話給my god	telephone
把我打開淘寶的網頁	website
滷豬蹄怎麼做？	cookbook
土豆餅怎麼做啊？	cookbook
文娛播報	video
給我來首絕句。	poetry
可是我不喜歡你了兩個億你你一點也不忙啥子	chat
企鵝啥	chat
烏鴉二電視沒	video
在菏澤怎麼坐去北京的車。	bus
家，背首沁園春雪。	poetry
中國太保股票	stock
不這樣稱呼你怎麼樣呢	chat
時間現在的	datetime
現在中央一臺在播什麼節目？	epg
雄關漫道真如鐵下一句是什麼？	poetry
幫我調到安徽衛視	tvchannel
蛋糕可以做蛋糕嗎？	cookbook
現在我也想上新浪網了	website
你平時喫什麼	chat
好無聊哇有什麼好看的電影	video
打電話給大哥	telephone
電視臺現在在播放什麼大陸動漫	epg
火腿腸怎麼炒好喫	cookbook
查詢宜春到南昌的火車列車時刻表	train
我現在要發一條信息	message
怎麼調用QA	chat
你爸爸好嗎	chat
查詢海螺水泥的股票	stock
我想要轉發這封郵件	email
跳的人我想要了嗎	chat
那來個燈謎吧！	riddle
鐵甲鋼拳	video
買的什麼	chat
你包郵嗎	chat
有什麼新電影	video
喜歡喫什麼	chat
你都能回答我什麼問題	chat
萬里鵬是誰	chat
酷狗音樂盒	app
你忍心嗎	chat
讀一首唐詩。	poetry
李瑞英主持的最新的新聞節目	video
來一首聽你聽我	music
最近有什麼新片子？	cinemas
晚上好用英語怎麼說	translation
冰糖葫蘆怎麼做？你？女子。	cookbook
松江鋼材城在哪裏	map
你能分析上下文嗎	chat
智能手機英語怎麼說	translation
什麼時候和張三去步行街	schedule
你愛玩嗎那我也不要聽你話了嗎	chat
有什麼好聽的歌	chat
那你爸給我背一首唐詩了。	poetry
龍巖新聞	news
你說啥呢	chat
唱一首兩隻蝴蝶。	music
移動公司在哪裏呀	map
炒雞蛋，需要，哪些材料？	cookbook
你叫什麼名字翻譯一下	translation
天空什麼顏色	chat
你是不是啥	chat
昨天晚上湖南衛視演什麼	epg
幫我查一下洛陽到贛州的火車	train
喂喂能聽我說話嗎	chat
來一首唐詩嗎？	poetry
九陰真經	website
你能幹嘛？	chat
給劉志發短信	message
土豆燒肉。	cookbook
廣東省英德在哪裏	map
能介紹一下嗎	chat
做糖醋排骨	cookbook
水果沙拉怎麼做？	cookbook
安陽到鄭州的火車	train
訊飛語點我現在在哪裏	map
安安昨天11:07的風華國樂	epg
臭豆腐湯怎麼燒？	cookbook
茶用英語怎麼說呀	translation
鴕鳥第一件寶貝是什麼	chat
打開搜狐網首頁	website
我想聽首唐詩。	poetry
給我來首好聽的音樂	music
撥打幺零零八六一一	telephone
翻譯牛	translation
打開科大訊飛網站	website
告訴我西安的位置	map
今天有什麼軍事新聞	news
我要點一首小星星	music
科大訊飛在哪裏呀	map
我要聽李白的詩。	poetry
現在熱門的電視劇是什麼	epg
你喜歡有錢人嗎	chat
說一首唐詩吧！	poetry
居然股份股票怎麼樣	stock
招商銀行港股的股價	stock
西昌到成都的航班	flight
列車深圳到廣州	train
喂喂那個我說想聽音樂呢	music
寶寶你這是在賣萌嗎	chat
青椒肉絲怎麼做怎麼炒？	cookbook
發短信給姐姐說晚上一起吃麪條	message
胃潰瘍。	health
播放特種兵之利刃出鞘	video
找下最近最熱播的電影。	cinemas
查一下濟南到濰坊昌樂的火車	train
哪個臺在放甄嬛	epg
什麼時候去	chat
啓動qq瀏覽器	app
今晚什麼節目呀？	epg
手抓餅的做法。	cookbook
西紅柿炒蛋怎麼煮？	cookbook
什麼電視臺什麼時間有轉播仁心解碼2	epg
幫我查一下2013年2月8日開獎的15選5中獎號碼	lottery
中超比賽時間多少啊？	match
懷化喫什麼	chat
烤肉串。	cookbook
涼拌海蜇怎麼做好喫？	cookbook
郭敬明的愛情小說《悲傷逆流成河》	novel
發短信給幺五八三七五幺幺幺四幺	message
螃蟹怎麼蒸？	cookbook
看看今天有什麼好看的節目？	epg
青魚的做法。	cookbook
爲什麼叫這個名字	chat
查一下澳門到吉隆坡的飛機	flight
落花不是無情物的下一句是什麼？	poetry
翻譯共產黨員	translation
你竟然還知道什麼是罵人	chat
恐龍用尾巴幹什麼	chat
零七播報新聞。	news
你會猜謎語嗎？	riddle
那麼最近有什麼好電影呢？	video
幫我找一找龍門飛甲	video
自演藝，羊肉怎麼做？	cookbook
去倫敦的航班	flight
我要買彩票。	lottery
看看鄭曉龍導演的甄嬛傳	video
怎麼做滷豬腳	cookbook
CCTV6電影高清	tvchannel
罐燜牛肉怎麼做？	cookbook
查一下上海到蘇州的火車票	train
烤鴨，啊！	cookbook
你會做菜嗎?	chat
西紅柿用英語怎麼說	translation
詩中共出現了幾種顏色	chat
請播放一下舉起手來	video
你讀幾年級了	chat
腸易激綜合徵。	health
我要全部回覆	email
發燒。	health
我想知道皮蛋瘦肉粥是怎麼做的	cookbook
請幫我調頻89.7上虞人民廣播電臺	radio
往火車北站怎麼走	map
幹豆角怎麼燒？	cookbook
你好我想看電影	video
永高股份的股票	stock
唱一下你是誰	chat
把uc打開啊	app
舒城的天氣	weather
幫我查一下贛州到南昌的火車票	train
愛笑會議室什麼時候播放	epg
你酸辣土豆絲怎麼做？	cookbook
給張張打電話	telephone
去科大訊飛怎麼走	map
炒豆腐。	cookbook
人民公園在哪裏	map
好今天天氣怎麼樣	weather
潛山到福州的火車	train
劉一佳是誰	chat
我想聽歌曲傳奇	music
查看大樂透玩法的開獎	lottery
你告訴我爲什麼	chat
這是啥	chat
吉林電視臺	tvchannel
到鼓樓怎麼走	map
最新的熱門電影是什麼呀？	cinemas
百大	stock
播放最近新聞。	news
呼叫鵬鵬	telephone
央視綜合高清	tvchannel
我沒去哪兒啊	chat
通寶能源股票	stock
杜甫的詩。	poetry
我聽首歌	music
看當前直播的比賽	epg
調到新疆綜藝	tvchannel
那你爲什麼不修	chat
央視少兒頻道的節目的	epg
下半年的電視劇	video
你喜歡喫什麼呢	chat
也來個燈謎嗎？	riddle
水裏有什麼	chat
爆笑謎語	riddle
非誠勿擾什麼時候演啊	epg
哦哦，查一下香港最新上映電影。	cinemas
哪年呀	chat
勁爆在車	video
什麼太美了	chat
查一下到長途汽車站去的最省錢的線路	map
哦買噶誰開發的你這麼猥瑣	chat
什麼理由	chat
你不喜歡哪個顏色	chat
一千五英語怎麼說	translation
要回應的這麼賤麼	chat
CCTV四套	tvchannel
北流的天氣	weather
色情暴力嗎	chat
你知道葉哲是誰嗎	chat
國際新聞。	news
你出錢嗎我沒有錢	chat
麪包的配方。	cookbook
高清動作電影	video
打電話給幺三二三五六二零二五五	telephone
月詠牡丹的下一句，是什麼？	poetry
地心歷險記二	video
咱們結婚吧什麼時候播出	epg
說蘿蔔怎麼做？	cookbook
還有多少天過年	datetime
幫我查一下紅燒肉的做法	cookbook
最近有什麼好看的電視連續劇武打的。	video
餛燉怎麼做？	cookbook
蒸雞蛋糕	cookbook
放一首音樂給我聽	music
小說英語怎麼說	translation
魔幻劇	video
秋娃娃寫信給誰	chat
搜索娛樂新聞。	news
訊飛語音我想知道山東省東營市今天的新聞。	news
怎麼燒西紅柿炒蛋	cookbook
想唱就唱	video
到公園怎麼走	map
杜甫兵車行。	poetry
翻譯一下明天我跳河自殺	translation
我想到科大訊飛怎麼走	map
春熙路怎麼走	map
電影私人定製	video
包鋼稀土股票價格	stock
打一下公司張總的電話	telephone
中央電視臺少兒頻道大耳朵圖圖	epg
哦，中超比賽時間三比五。	match
去常州武進路線	map
冷麪的做法。	cookbook
你是什麼意思呀	chat
熱火NBA季前賽的那個賽程。	match
你需要喫東西嗎	chat
查詢北京到上海的路線	map
怎麼治感冒？	health
動畫片巴啦啦小魔仙	video
說話，給我搜一下做蘋果麥片粥是怎麼做啊？	cookbook
CCTV8高清電視劇	tvchannel
我要聽勸化這首歌	music
54的立方再加上35	calc
現在幾號	datetime
我想全部迴應	email
週二電影。	epg
鋤禾日當午，下面一句是什麼？	poetry
男朋友總借錢怎麼辦	chat
打電話給美華	telephone
從這裏到市中心怎麼走	map
給我定一張株洲到深圳的機票	flight
播放神話	video
你認識siri嗎	chat
幫我打開c c t v五	tvchannel
我要寫條新郵件	email
明天有火車到襄陽嗎	train
最近的新電影有哪些？	cinemas
甲亢。	health
從哪回來	chat
美菱電器的昨日收盤價是多少	stock
可不中央五套明天的節目單	epg
玄幻小說 幻神	novel
查詢恆光電影院即將上映的電影	cinemas
白天干什麼	chat
打一個燈謎啊，你。	riddle
隨便給我放幾首歌	music
斯皮爾伯格導演的電影	video
中國新華網打開	website
查一下最近有什麼電影？	video
你愛喫嗎	chat
你和小冰有什麼不一樣	chat
大腸癌	health
後天什麼天氣	weather
給我查一下，乳腺增生怎麼治療？	health
你希望我分手嗎	chat
新建聯繫人王滿秀幺三七 六四零七零二九五	contacts
幹嘛去？	chat
來首李白的詩集。	poetry
我要看唐家三少寫的玄幻小說絕世唐門	novel
搜索小說校園全能高手。	novel
今晚安徽衛視有什麼節目	epg
幫我調頻92.4中國國際廣播電臺行不行？	radio
打石寶電話	telephone
can you speak English?	chat
給我講一個謎語吧！	riddle
涼皮的製作方法。	cookbook
我要猜一個字謎。	riddle
發短信給王小露的	message
。咳嗽	health
有體育方面的嗎	chat
NBA比賽時間。	match
草莓芒果西米露。	cookbook
那你最愛的人是誰	chat
上海回合肥怎麼坐汽車	bus
影視頻道有什麼節目	epg
咖喱牛腩怎麼做	cookbook
3的平方除以2的立方的商減去4的平方根的立方	calc
看看現在幾點幾分	datetime
特莫文蔚的陰天。	music
你研發團隊有些誰	chat
我不知道的英文怎麼說	translation
你願意做娟的女朋友嗎	chat
那你是不是很苗條呢	chat
你聽說過這句名言嗎	chat
青蛙在做什麼	chat
廣西新聞網	website
嗯我幫你啥	chat
單個詞是什麼情況	chat
甲魚，鄧雞，如何製作。	cookbook
上百度網站	website
動畫片	video
涼拌菜	cookbook
什麼新聞呢	chat
播放斷點	music
誰告你我的名字的	chat
是說我好嗎我逗你玩兒	chat
對了嗎	chat
你的好朋友是誰	chat
你知道水嗎	chat
截止目前銀鴿投資股份的市值是多少	stock
炸饅頭片	cookbook
調頻fm九十六點三	radio
替我答覆這條郵件	email
幫我查一下蘇州到上海的火車	train
唉你叫什麼名字	chat
甜酒怎麼做？	cookbook
土豆炒肉絲的做法	cookbook
湖南臺演什麼節目	epg
找湖南衛視	tvchannel
你好像沒理解我我真的在倒時差有什麼可以讓我睡覺的方法麼	chat
來一個字謎，二。	riddle
發信息給學超	message
南光集團怎麼走	map
紅燒豬腳怎麼做啊？	cookbook
你家在家還是如家	chat
這麼誇張	chat
幫我寫一封郵件	email
聽時間煮雨這首歌	music
查詢今天成都到北京的航班	flight
半夜不要照鏡子	video
明天上午9點距離現在還有多久	datetime
刑偵電視劇	video
幫我網上訂車票	train
請幫我調一下電臺到鎮江新聞廣播	radio
我想聽你最珍貴這首音樂	music
幫我查詢一下溫州到上海的火車	train
現在是兩點了嗎	datetime
酸菜魚怎麼煮啊？	cookbook
王菲傳奇。	music
給靖哥哥發短信說我不回來喫飯了	message
蒼狼	video
廬山天氣	weather
請告訴我清蒸桂魚怎麼做？	cookbook
另一個8:10的鬧鐘。	schedule
福爾摩探案急翻譯成英文	translation
哪個飯店好喫	chat
進入三w點百度點com	website
六零零零三六昨天的漲跌幅情況	stock
請查詢一下深圳飛往上海的航班	flight
給黃槓發短信	message
新建聯繫人孫曉飛幺三八三八四四三八九五	contacts
到科大訊飛怎麼走更快一些	map
高清央視綜合頻道	tvchannel
125的立方根	calc
紅燒排骨怎麼做的嗎？	cookbook
王石的事你怎麼看	chat
查尋標兵的號碼	contacts
糖醋鯉魚怎麼做？而？	cookbook
棗莊到淄博的火車票	train
我要看靈異推理小說	novel
高淳轉播2	tvchannel
河南衛視節目單。	epg
舊金山幾點幾分	datetime
你，湖南衛視正在播出什麼？你。	epg
你在什麼地方	chat
我想看看股票零零二幺幺八紫鑫藥業股吧	stock
上海飛往北京的航班	flight
我是你什麼人	chat
背將進酒。	poetry
我想看周星馳的喜劇電影喜劇之王	video
腎虛怎麼治療	health
東方高清檯的節目單	epg
丁效是誰	chat
中超比賽時間，我。	match
頭暈該怎麼辦？	health
發信息給蘇建江	message
坐宮保雞丁需要哪些材料？	cookbook
狸貓換太子	video
查看七樂彩的得獎號碼	lottery
搜索15選5的號碼信息	lottery
我是說我要看一起又看流星雨	video
釣魚島事件。	news
關於釣魚島的新聞進展	news
湖北荊州到黃石的火車	train
媽媽說了什麼	chat
關節痛怎麼辦？	health
每天8:10起牀。	schedule
金山詞霸	app
陳醋排骨的做法。	cookbook
ok好，來首李白的詩詞。	poetry
油燜大蝦怎麼做	cookbook
背一下春曉孟浩然。	poetry
新建聯繫人18622625490	contacts
這麼多回答不了的問題	chat
時間的英文怎麼講	translation
你是不是被我弄瘋了	chat
這麼裝逼	chat
想看韓劇	video
呼叫a 二小姐	telephone
什麼是色	chat
中國新聲代	video
近視眼怎麼治療	health
你在哪裏上學啊	chat
啊腦筋急轉彎啊	riddle
排骨堡湯的做法。	cookbook
我想聽想唱就唱	music
我要查看郵件	email
那那個什麼你真是好可愛的小貓呀	chat
北京財經臺	tvchannel
發郵件給晶晶	email
人們誇獎誰	chat
上饒到南昌的火車票	train
我在想怎麼回去比較好	chat
哦，安徽衛視今晚放什麼節目？	epg
怎麼樣？做紅燒肉。	cookbook
怎麼去龍陽路	map
小是什麼	chat
做紅燒肉要哪些材料呀！	cookbook
電影頻道明天放什麼	epg
乾鍋排骨怎麼做？	cookbook
邳州的天氣	weather
你是好人嗎	chat
孔寧是不是傻逼	chat
從廈門到昆明的飛機	flight
小杰燉蘑菇怎麼做？	cookbook
酸辣湯的做法。	cookbook
聽新聞，姨。	news
美國大使館在哪	map
查一下到洛陽的高鐵	train
胖魚頭怎麼燒？	cookbook
星光做西紅柿炒雞蛋呢！	cookbook
肩周炎，要怎麼治療。	health
背一首，納蘭容若的詞。	poetry
7月13號廣州恆大俱樂部的比賽有哪些	match
什麼時候有西遊記呢？	epg
把李文鼎的號碼發給謝服全	contacts
怎麼做炸雞腿？	cookbook
白灼基尾蝦的做法。	cookbook
上海到合肥可以到哪坐車	bus
西方誰可以談笑風生	chat
登錄不行，做燒雞公學，我愛你！	cookbook
講個謎語猜一下。	riddle
你知道中國科技大學在哪裏嗎	map
本省農村廣播	radio
炒四季豆。	cookbook
A是什麼	chat
調頻到fm八九八	radio
株洲的天氣怎麼樣	weather
提醒我8:10起牀。	schedule
你是男生還是女生	chat
這麼有趣啊	chat
幺三五八四四七零五零二	telephone
查找通訊錄	app
我想看喜羊羊	video
看中國好聲音	video
咳嗽怎麼辦	health
請幫我查找一下奧特曼大電影	video
長春的天氣	weather
和配麼	chat
你們好嗎	chat
撥號曹興發	telephone
昭通到南昌的汽車。	bus
幫我查下天氣	weather
明天贛州什麼天氣	weather
你爲什麼這麼開心	chat
何以解憂的下一句是什麼？	poetry
葫蘆雞怎麼做？	cookbook
你能安慰我嗎	chat
橙子的英文怎麼說	translation
找你幹什麼	chat
我想答覆這個郵件	email
朗誦詩詞。	poetry
腎積水怎麼治？	health
讓我猜個謎語。	riddle
爲什麼要想你	chat
有上海到崑山的火車嗎	train
李清照的詩。	poetry
到北京的飛機。	flight
散貨演繹的作者是誰？	chat
香蕉用英語怎麼講	translation
蔥燒海蔘怎麼做	cookbook
我想看大武當電影	video
貴陽到哈爾濱飛機	flight
發信息給健美	message
你現在在哪	chat
我想聽水墨丹青這首歌	music
海蔘怎麼做？	cookbook
要怎麼打你	chat
北京國安的賽程。	match
青島海信股票	stock
我回去看昨天晚上播出的爸爸去哪兒31頻道	epg
豐田車在哪裏生產的？	chat
把小新的號碼發給徐雲蔚	contacts
你有什麼夢想啊	chat
土豆的做法	cookbook
你喜歡什麼類型的女人	chat
下載飛信	app
今天柳州天氣怎麼樣	weather
打開調頻FM107南平人民廣播電臺	radio
雞怎麼做纔好喫？	cookbook
你談過嗎	chat
播放鬱可唯的歌	music
告訴我現在北京天氣怎麼樣	weather
我想要看很火的電影	video
狗肉怎麼做？	cookbook
合肥到上海可以到哪坐車？	bus
打開uc瀏覽器	app
披薩的做法	cookbook
分手時，背一首詩吧？	poetry
姨，最近有什麼新聞。	news
誰寫的你	chat
到武漢的航班	flight
淮南天氣預報	weather
鹽水鴨怎麼做？	cookbook
打開天天動聽並開始播放音樂	app
搜索中國共產黨章程	novel
正者無敵	video
查詢明天南陽到上海的航班	flight
我想聽，新聞。	news
平安保險的股票價格	stock
北京下雨了嗎你個蠢蛋	chat
我不喫英文怎麼講	translation
英雄本色電影	video
有沒有新出的電影了。	cinemas
米粉怎麼炒？	cookbook
你可以二十四小時陪我聊天嗎	chat
把張新濤電話發給常勝賓	contacts
搜索遊戲	app
幫我找一首我的好兄弟	music
噗我想聽新聞。	news
你是男機器人還是女機器人	chat
來一首寶貝對不起	music
你咋知道	chat
我要聽最近的新聞。	news
中超賽事預告嗎？	match
明天早晨8:10的鬧鐘。	schedule
給我講個笑話吧，魚香肉絲怎麼做？	cookbook
你好啊，再背首詩。	poetry
來首甘露寺。	poetry
來個字謎嗎？	riddle
你覺得我美嗎	chat
肩周炎怎麼治？	health
查下銀星能源股票	stock
想聽牽手這首歌	music
查一下濰坊到威海的火車票	train
從合肥到上海可以到哪坐車？	bus
你知道我的名字嗎	chat
我是特種兵二	video
我想看珍珠港	video
給謝小培發短信今晚一起喫飯	message
骨折了怎麼辦？	health
你是微軟小冰嗎	chat
央視精品節目	tvchannel
紅棗雞湯怎麼煲？	cookbook
康熙大帝	video
我給你打電話行嗎	chat
戀愛着東西很玄虛，誰都說不準	chat
我想聽求佛。	music
到合肥市逍遙津公園怎麼走	map
肉沫茄子，怎麼做？	cookbook
醉蝦的做法。	cookbook
你給樸叔打電話	telephone
現在幾度	weather
你知不知道三十四加六十五等於多少	calc
廣州的天氣如何	weather
漢武大帝	video
打開4399小遊戲	website
在線觀看中央七套	tvchannel
我想知道科大訊飛的市值	stock
我如果說一句什麼你纔不會回覆	chat
包皮過長怎麼辦啊？你。	health
查下溫州到杭州的火車票	train
你就是你爲什麼會打字兒啊	chat
總計今天的新聞。	news
聽江蘇交通廣播網	tvchannel
我餓用英文怎麼說	translation
給我看看什麼時候有播盛夏晚晴天	epg
你會唱歌嗎	chat
長風吹月渡海來下一句是什麼？	poetry
有沒有張藝謀導演的熱門電影	video
什麼時候咱倆見一面吧	chat
打開汕頭的天氣預報	weather
明天什麼日子	datetime
給我隨便來幾首歌	music
乾鍋排骨蝦怎麼做？	cookbook
找一首歌叫斑馬斑馬	music
哪個頻道演爸爸去哪兒	epg
我想聽老婆這首歌	music
打一個謎語男人的腿殘。	riddle
明天想喫啥呀	chat
我不確定具體啥時間去呢	chat
打開網頁小米論壇	website
從合肥到北京的列車	train
怎麼炒南瓜？	cookbook
幫我查一下廣州到深圳的火車	train
魚香肉絲，怎麼做？買？	cookbook
的，酸菜魚怎麼做？怎麼？	cookbook
寧波一臺	tvchannel
米飯怎麼做	cookbook
燉肉	cookbook
CCTV記錄	tvchannel
我是個女的，你知道怎樣治脫髮嗎	health
書包用英語怎麼說	translation
我想聽足球類新聞	news
搜索古詩絕句。	poetry
你是詹黑嗎	chat
看鄉村愛情	video
安徽衛視今天晚上放什麼？	epg
你的性格怎麼樣	chat
幫我找一下涼拌海蜇的做法。	cookbook
快樂大本營什麼時間播？	epg
你也是什麼	chat
什麼跌了	chat
秋葵怎麼做？	cookbook
蔣能能是誰	chat
給丹丹發信息我一會兒就回來別等我了	message
給幺零零幺零打電話	telephone
發短信給張三說“畫皮2在哪個臺播出”	message
李白的詩詞	poetry
來首蘇軾的詞。	poetry
濟南到重慶的航班。	flight
導航到建八路	map
溼疹怎麼處理？	health
是誰開發了你	chat
明天到鄭州的火車	train
再來背一首毛澤東的詩詞。	poetry
亳州天氣	weather
找一首游鴻明的音樂	music
給我念首春曉。	poetry
幫我翻譯一下我餓了	translation
最近有什麼科幻電影？	video
打電話給李新穎	telephone
那我要怎麼做	chat
我可以幫你嗎	chat
我來自美國是一個地地道道的美國人用英語怎麼說	translation
我要看熱門電影。	cinemas
我想上qq了	app
搜索京東商城	app
我要看湖南衛視快樂大本營	epg
搜索合肥左岸國際電影城。	cinemas
啥道理	chat
你什麼時候去北京	chat
從長沙到北京的列車	train
中國工商銀行的股票	stock
狗光魚怎麼做？	cookbook
你能識別語音嗎	chat
明天上午8:10叫我起牀。	schedule
查詢廈門到武夷山的航班	flight
不是花中偏愛菊的下一句是什麼？	poetry
寶寶你不是很小嗎	chat
現在不是這個時候大好嗎我的大還有沒有什麼時光網	chat
高清江蘇	tvchannel
我要看饒雪漫的小說左耳	novel
4的平方根	calc
北京到鎮江的火車	train
上海能源這支股票怎麼樣	stock
明天溫州到上海的航班。	flight
來一首夜夜夜	music
把李志強的號碼發給賈洪鑑	contacts
蝦仁飯。	cookbook
還是笨笨的	chat
查詢大力傳媒的股票	stock
狄仁傑之通天帝國視頻	video
煮咖喱飯。	cookbook
查一下明天晚上17點30分從上海飛往珠海三竈機場的飛機	flight
中國銀行是跌了還是漲了	stock
喫完飯之後幹什麼	chat
請幫我調頻105.8南京人民廣播電臺音樂臺	radio
45的三次方	calc
鄱陽縣的天氣	weather
笨笨誰設計了你	chat
北京國安5月23號比賽和誰踢	match
蔥爆羊肉的做法。	cookbook
看看大樂透的得獎號碼	lottery
可樂雞翅是怎麼做的	cookbook
我想全部回覆	email
失眠怎麼辦呀	health
什麼時候開發出來的	chat
幫我設定8:10的鬧鐘。	schedule
力氣大的螞蟻在幹什麼	chat
查一下合肥到淮南明天的火車	train
到薛城區怎麼走	map
哪家店比較有名	chat
哪裏香我來一首李白的詩。	poetry
怎麼做水煮魚店？	cookbook
隨便來首劉德華的歌。	music
腦筋急轉彎唄！	riddle
查一下明天合肥到北京的航班。	flight
豆腐花的做法。	cookbook
何超盈是誰	chat
我看呀中央五臺	tvchannel
夫妻肺片怎麼做？	cookbook
換到米老鼠	video
我去煙臺有高鐵嗎	chat
你知道我喜歡哪個女生嗎	chat
好看足球比賽	video
把唐玉明的手機號碼發給李康	contacts
查詢洛陽鉬業的股票	stock
五零零零零五的市值高不高	stock
情景劇電視劇	video
你說啥了	chat
看看有什麼好新聞	news
開車嗎壞笑	chat
怎麼炒番茄炒？	cookbook
你認識微軟小冰麼	chat
打開騰訊頭條新聞	news
魚怎麼做萊	cookbook
中華軍事網	website
搜索歌曲公路	music
得了灰指甲怎麼辦？	health
安徽綜藝	tvchannel
鐵板燒怎麼做？	cookbook
8:10提醒我吃藥。	schedule
哎，你還是沒有上下文啊	chat
新建聯繫人王義勇幺三八六零零幺九四九零	contacts
來一個選秀節目	video
可以找一下浪漫滿屋的小說	novel
然後等你殺豬菜怎麼做？	cookbook
甘肅臺	tvchannel
親愛的孟凱韜	video
涼拌海帶	cookbook
如何煮牛肉飯。	cookbook
給秦麗香發信息	message
發短信給劉文說明天下午五點有聚會	message
明天廣州到北京的火車	train
BTVKAKU少兒	tvchannel
江山	video
幫我找菜單	app
獨立縱隊電視劇	video
還路阻少茶湯的做法。	cookbook
江涵秋影雁初飛的下一句是什麼？	poetry
發信息給陳明哲	message
發短信給張三我明天去北京	message
今天啥天氣啊	weather
這是誰唱的歌？	chat
給嚴巧發短信	message
從溫州到西安的汽車。	bus
紅燒芋頭做法。	cookbook
打開應用程序錢包	app
死亡復生	video
讀心專家	video
放一首其實我介意	music
腎炎需要注意什麼？	health
詩詞滿江紅。	poetry
打開天天動聽播放站你名下	app
查一下綿陽的天氣預報	weather
提醒我明天約了。	schedule
你會查火車票麼	chat
你信什麼	chat
滿園花菊鬱金黃的下一句是什麼？	poetry
把哥哥的電話發給殷龍	contacts
幹嘛弄瘋你啊😌	chat
湘潭到常德怎麼走	map
誰製造的你啊	chat
我要看下中央六套	tvchannel
湖南衛視明天播什麼節目	epg
聽到沒有，提醒我晚上有約會記得穿正裝	schedule
你不是人吧我怎麼覺得你是人呢	chat
打電話給張志國	telephone
奧克蘭的天氣	weather
寧波機場在哪裏	map
你家人有誰	chat
濰坊到濟南的火車票	train
饅頭怎麼做嗎？	cookbook
搜索聲控安卓軟件	app
打電話給小女兒	telephone
還有多少分鐘12點	datetime
來點張藝謀出演的節目	video
我想聽周杰倫的菊花臺	music
孫曉飛是誰	chat
心絕網上人間	website
打開四三九九小遊戲網站	website
宏達高科的股票跌了沒有	stock
請幫我放一下剩女保鏢	video
有什麼特色美食。	cookbook
打開qq找楊佳藝	app
你給我說幾個謎語。	riddle
這麼任性	chat
四月二十日合肥到深圳的航班	flight
廈門到上海的機票	flight
下載漢化軟件	app
你怎麼知道我不知道	chat
查一下從南京到上海的航班	flight
我要聽宋詞。	poetry
熱血動漫	video
給德師傅發短信	message
查詢一下訊飛科大今天的股票	stock
查看王老師的號碼	contacts
搜索最新新聞	news
故宮魚怎麼做？	cookbook
劉詩詩主演過的電影	video
來一首解脫	music
書畫頻道上週六有開始非誠勿擾麼	epg
幫我寫一條新郵件	email
幫我調轉到風雲音樂頻道	tvchannel
打開浦口新聞綜合頻道	tvchannel
豬肉怎麼做？	cookbook
哎你好我的夢想是什麼	chat
高爾夫網球	tvchannel
雨點怎麼樣	chat
哪裏哪裏	chat
國足最新賽程。	match
臥槽一個答非所問的AI有什麼用	chat
再問一遍誰是最美的人	chat
今天溫州有什麼新聞。	news
給馬翊桐發信息	message
吃藥了嗎	chat
紅燒排骨怎麼做？	cookbook
喝酒嗎	chat
紅燒豬蹄怎麼做	cookbook
宜家	website
鐵甲威蟲	video
後天上海到煙臺的火車	train
你怎麼了英文怎麼講	translation
五用英語怎麼說	translation
請背誦靜夜思。	poetry
你是巧婦還是米	chat
爲什麼工數大物學不會	chat
賀歲片	video
你們什麼搞笑劇	chat
帶我去新都會	map
少兒節目中央少兒節目	epg
給我寫一個新郵件	email
打開新聞	video
看東方	video
那你查一下最近的熱門電影是什麼？	cinemas
江蘇教育臺	tvchannel
768的女朋友是誰	chat
從從合肥到北京的航班	flight
幺三八五幺二九二四幺四	telephone
2的2次方	calc
爸爸媽媽你最喜歡誰	chat
你給我講講紅燒肉的做法。	cookbook
麻煩您可不可以幫我調頻98.5揚州人民廣播電臺新聞臺	radio
搜索一下熱門電影。	cinemas
電子競技場	tvchannel
幾個田今天天氣怎麼樣	weather
搜索泰亞股份股票	stock
給我定個8:10的鬧鐘。	schedule
今天什麼好看電影？	epg
滿秋	video
恩，紅燒土豆怎麼做我想學？	cookbook
你怎麼不害羞呀	chat
怎麼做煎餅？	cookbook
推理動漫	video
明天去深圳的飛機	flight
幫我查一下上一期的大樂透	lottery
設定鬧鐘。	schedule
冰糖雪梨	cookbook
梅毒怎麼治療？	health
當婆婆遇上媽	video
打開江蘇衛視	tvchannel
讀一首古詩。	poetry
我想聽只對你有感覺	music
幫我打開步步驚心	video
四八七三一六六	telephone
南瓜餅的做法。	cookbook
松菇雞湯的做法。	cookbook
有什麼錢	chat
你知道北京他們嗎	chat
八月一號去上海的航班	flight
你的父母是誰	chat
字謎你。	riddle
查詢日期	datetime
土豆絲是怎麼炒？	cookbook
查查什麼時候放百變大咖秀	epg
你會不會做蛋糕只能回答哦。	cookbook
我要操蝦米的做法。	cookbook
股票零零零零零二	stock
中央電視臺電影頻道	tvchannel
哈哈哈幹什麼也想你到底是不是本	chat
c c t v法語頻道	tvchannel
你端午節放假麼	chat
富瑞特裝股票	stock
