account = 戶頭, 帳戶, 帳號, 戶
activate = 開卡, 開
adjust = 調整, 調額, 調, 調高, 調低, 設定, 變更, 改, 修改, 提高, 降低, 增加, 減少
air_ticket = 機票, 飛機票
airport = 桃園國際機場, 桃園機場, 松山機場, 小港機場, 小港國際機場, 機場, 桃機, 松機
airport_pickup = 機場接送, 機接
already = 已經, 已
assist = 救援,
atm = 提款機, 自動提款機, atm
auto = 自動
bank_business = 匯款, 外幣, 存匯, 外匯, 貸款, 基金
bid = 申辦, 辦卡, 申請, 辦, 辦理, 申
bill = 帳單, 對帳單, 單子, 卡費, 信用卡費, 費
card_components = 薄膜, 磁條
card_loan = 卡友貸, 卡貸, 友貸
cash_advance = 預借現金, 預借, 借, 預支, 借錢, 預現
check = 支票, 支存, 票款, 票
checkout = 結帳, 結算, 關帳
code = 代碼, 代號
credit_card = card, ubear, 信用卡, 信用卡處, 信用, credit, 玉山卡, 卡片, 卡款, master卡, only卡, 宏匯卡, 醫師卡, 刷卡, 聯名卡, 國旅卡, 簽帳卡, 信用卡款, 教師卡, 公務人員國民旅遊卡, 國民旅遊卡, 拍卡, pi卡, 拍錢包信用卡, 拍錢包卡, pi錢包卡, 拍錢包, pi錢包, p幣卡, 南山悠遊聯名卡, 南山卡, 南山聯名卡, 認同卡
current = 本期, 這期, 這一期, 這次, 本次, 最新, 目前, 現在
date = 日, 日期, 時候, 哪一天, 期限, 幾號, 何時, 時間
deadline = 到期, 期限
debit_card = 金融卡, 卡片, 刷卡, debit卡, debit, 簽帳卡, 存摺
delete = 刪除, 砍掉, 砍, 刪, d掉
delivery = 交割
deposit = 存款
dept = 債務, 欠款, 尚欠, 欠, 未繳, 待繳, 欠費, 應繳
detail = 明細
digital = 數位, 數位帳戶, 無卡, 無卡提款, 網路銀行, 網銀, 跨境e指購, 全球通, paypal
discount = 紅利, 優惠
doubt = 嗎, 是否, 是不是, 有沒有, 疑問
dream = 圓夢
easy_card = 悠遊卡
ebill = ebill, e-bill, 全國繳費網, 全國繳款網
electric = 電子
email = mail, e-mail, 電子郵件, 電子信箱
esun = 玉山, 本行, 玉山銀行
examine = 檢核, 審核
exchange = 兌換, 換
fax = 傳真
forward = 轉接, 打電話, 電話, 專人, 真人, 專員, 服務人員, 找, 轉給, 轉到
give = 贈送, 送
handling_fee = 手續費, 處理費, 工本費
how = 如何, 怎麼, 怎樣, 什麼
how_much = 多少, 
id = 身分證字號, 身分證
info = 帳號
installment = 分期, 分期付款, 首期
insurance = 保險, 保單, 保費, 產險, 壽險, 南山人壽, 南山, 人壽, 三商美邦, 車險, 險
interest_rate = 利率, 零利率
least = 最後, 最晚, 過期, 截止
loan = 貸款, 信貸, 房貸, 貸
loss = 遺失, lost, loss, 掉了, 丟了, 不見, 不見了, 找不到, 掛失, 沒收到, 未收到, 丟, 盜刷
makeup = 補, 補繳, 補票, 補發
method = 方法, 方式
miles = 哩程, 航空哩程
min = 最少, 最低, 至少
mobile = 行動
money = 金額, 錢, 資金, 現金
nagative = 尚未, 還沒, 沒有
need = 需求, 需要, 急需
next = 下期, 下一期, 次月, 下個月
notify = 照會
other = 其他
other_bank = 他行, 跨行, 別家, 一銀, 三信, 三信商業銀行, 三信銀行, 上海商業銀行, 上海商業儲蓄銀行, 上海商銀, 上海銀行, 土地商業銀行, 土地銀行, 土銀, 大眾商業銀行, 大眾銀行, 中小企, 中小企商業銀行, 中小企銀, 中小企銀行, 中信, 中信金, 中信金控, 中國信託, 中國信託商業銀行, 中國信託銀行, 中華郵政, 中華郵政股份有限公司, 元大, 元大金, 元大金控, 元大商業銀行, 元大銀行, 元大證券金融公司, 友行, 日盛國際商業銀行, 日盛國際銀行, 它行, 他家, 他家行庫, 他家商業銀行, 他家銀行, 台中商業銀行, 台中銀, 台中銀行, 台北富邦, 台北富邦商業銀行, 台北富邦銀行, 台新, 台新金, 台新金控, 台新商業銀行, 台新國際, 台新國際商業銀行, 台新國際銀行, 台新銀行, 台銀, 台灣商業銀行, 台灣銀行, 永豐, 永豐金, 永豐金控, 永豐商業銀行, 永豐銀行, 兆豐, 兆豐金, 兆豐金控, 兆豐商業銀行, 兆豐國際, 兆豐國際商業銀行, 兆豐國際銀行, 兆豐銀行, 全國農業金庫, 合作金庫, 合作金庫商業銀行, 合作金庫銀行, 合庫, 合庫金, 合庫金控, 同業, 安泰, 安泰商業銀行, 安泰銀, 安泰銀行, 別行, 別家, 別家商業銀行, 別家銀行, 別間, 別間商業銀行, 別間銀行, 京城, 京城商業銀行, 京城銀, 京城銀行, 其他行庫, 其他家, 其他家商業銀行, 其他家銀行, 其他商業銀行, 其他銀行, 旺旺保, 板信, 板信商業銀行, 板信銀行, 花旗, 花旗商業銀行, 花旗銀行, 星展, 星展商業銀行, 星展銀行, 高雄商業銀行, 高雄銀, 高雄銀行, 國泰, 國泰世華, 國泰世華商業銀行, 國泰世華銀行, 國泰金, 國泰金控, 國泰商業銀行, 國泰銀行, 國票金, 國票金控, 第一金, 第一金控, 第一商業銀行, 第一銀行, 凱基, 凱基商業銀行, 凱基銀行, 富邦, 富邦金, 富邦金控, 渣打, 渣打商業銀行, 渣打國際商業銀行, 渣打國際銀行, 渣打銀行, 華南, 華南金, 華南金控, 華南商業銀行, 華南銀行, 華泰, 華泰商業銀行, 華泰銀行, 華銀, 郵局, 陽信, 陽信商業銀行, 陽信銀行, 匯豐, 匯豐商業銀行, 匯豐銀行, 新光, 新光金, 新光金控, 新光商業銀行, 新光銀行, 瑞興, 瑞興商業銀行, 瑞興銀行, 萬泰, 萬泰商業銀行, 萬泰銀行, 彰化商業銀行, 彰化銀行, 彰銀, 臺企, 臺企商業銀行, 臺企銀, 臺企銀行, 臺銀, 臺灣工業, 臺灣工業商業銀行, 臺灣工業銀行, 臺灣中小企業, 臺灣中小企業商業銀行, 臺灣中小企業銀行, 臺灣商業銀行, 臺灣銀行, 遠東, 遠銀, 遠東商業銀行, 遠東國際, 遠東國際商業銀行, 遠東國際銀行, 遠東銀, 遠東銀行, 澳盛, 澳盛商業銀行, 澳盛銀, 澳盛銀行, 聯邦, 聯邦商業銀行, 聯邦銀, 聯邦銀行, 非本行
over = 超過, 爆, 用完, 沒了, 沒有, 沒
paper = 紙本
parking = 停車
parking_space = 停車場, 嘟嘟房, 連勝
password = 密碼, password, 密, 帳密
pay = 繳款, 付款, 繳錢, 交錢, 交, 繳交, 費用, 繳清, 自動扣繳, 扣繳, 扣款, 扣, 應繳, 繳費, 結清, 繳納
period = 定存, 定期, 定期存款
phone = 電話, 手機
pickup = 接送
post = 郵政, 劃撥, 郵政劃撥, 郵局
query = 查詢
quota = 額度, 限額, 總額, 上限
record = 紀錄, 記錄
remaining = 剩餘, 剩, 還有, 還, 餘額, 可用
request_payment = 請款, 已請款, 未出帳, 未列帳
reserve = 預約
reset = 重弄, 重設, 重新, 解鎖
lock = 鎖住, 鎖定, 上鎖
road = 道路
road_assist = 道路救援, 道救, 行遍天下, 拖車, 拖吊, 沒電, 拋錨, 爆胎, 車輛毀損
send = 寄, 補寄, 傳, 傳送, 補, 重發, 發送, 補發
sms = 簡訊, 手機簡訊
spend = 用了, 用掉, 花, 花掉, 刷, 花費, 消費, 使用
state = 到哪, 狀態, 怎樣, 怎麼樣, 進度, 情形, 狀況
stock = 證券, 玉證, 玉山證券, 股票, 富果
take = 索取, 取, 取件
telephone = 電話, 
ticket = 票信
transaction = 交易
transfer = 轉帳, 轉錢
travel = 旅遊
travel_insurance = 旅遊保險, 旅遊險
tuition = 學費
twd = 台幣, 臺幣, 新台幣, 新臺幣
under = 不夠, 不足, 太少, 少
vip = 貴賓室, 貴賓, 貴賓席, 貴賓卡, 龍騰卡, 貴賓廳 
voice = 語音
web = 網路, 線上, 網頁, 網
when = 何時, 時候, 多久
withdrawal = 提款
forget = 忘記, 忘掉, 忘了, 不記得